   NO            ./path_to_the_north_texture
SO ./path_to_the_south_texture
C  3,1,178
WE ./path_to_the_west_texture
EA ./path_to_the_east_texture
F  3,1,0



111111 111111111
111111000111111
100000001111111
1111000N10011111
111000001000111
110000000000011
10000111100001
110000111000011
111000010000111
111100000001111
111110000011111
111111000111111
111  111111 111111
