NO ./path_to_the_north_texture
SO ./path_to_the_south_texture
WE ./path_to_the_west_texture
EA ./path_to_the_east_texture
F  220,100,0
C 225,30,0

      111111111111111111111111
		      1N100000011000011
			101111111111100110000001
			1001100000000000000000001
 11111111111101100000111000000000111
100000000011000001110111111111111
11110111111111011100000010001
11110111111111011101010010001
11000000110101011100000010001
10000000000000001100000010001
1000000000000000001010010001
1100100111010101111101111000111
1111 01110111011 11011110101
  11111111111111111111111  
