F 220,        222, 1
C 225,30,0
NO hi.png

SO ./path_to_the_south_texture


WE ./path_to_the_west_texture
EA ./path_to_the_east_texture


1111
1N01            0  1
1011
10011
1011
10101
1001 1
111 11
